####################
#  I  #I#NNINS#S####
## E#IWE      SNWN##
#ENW@II I#ENNWISNEE#
#I# WI#   S SE EINI#
#N WEEI # I# SIS#NE#
#N#    I       #WSN#
#SS W#EIII#S#N#NN#S#
#I# #EIE  #WIENISIN#
#EEI SE## ##IE     #
#E I IIS###IN WN# W#
# I   S  I      IW##
# NWS# EI    NESESW#
#   I   I #NISEWIS##
###EES  WISNSW #ENN#
#EI#NI N  NSI$N#WIS#
# I     S#NNSIE#NSW#
##E ##ISIWI#I NE#IE#
#SSN   #  I  NW#S#W#
####################